44446444444444444444
44444444444644444444
44444444444444444644
44445444444644444444
44444444444444444444
44444444444544444444
44445444444444444444
44444444444444454444
44445444544444444444
44644444444444464444
44444445444444444444
44444444444454444444
44444544444444444444
44464444454444444444
44444444444444444444
45444444444544446444
44444446444445444444
44444444444444444444
44444544444444445444
44544444444654444444