11111111111113111111
11211131111131111211
11111111311311211111
11111112111311111111
11131121111111131111
11112111211121111311
11121111311111121111
11111111111211111131
11131113111111122111
13111311111121112111
11111111111111211111
11211131112111311111
11111111311111211111
11111112111211111111
11131121121121112111
11111111111131111111
11121111311111311111
11111111111112311111
11131113111111111111
13111311111121131111